,empty_slots,free_bikes,id,latitude,longitude,name,timestamp,extra.ebikes,extra.has_ebikes,extra.last_updated,extra.normal_bikes,extra.renting,extra.returning,extra.slots,extra.uid,total_slots
0,14,21,7a19c49f486d7c0c02b3685d7b240448,49.262487,-123.114397,10th & Cambie,2023-02-13T19:22:31.595000Z,4,True,1676316003,17,True,True,35,0001,35
1,7,9,32603a87cfca71d0f7dfa3513bad69d5,49.274566,-123.121817,Yaletown-Roundhouse Station,2023-02-13T19:22:31.591000Z,1,True,1676315894,8,True,True,16,0004,16
2,13,13,6d42fa40360f9a6b2bf641c7b8bb2862,49.279764,-123.110154,Dunsmuir & Beatty,2023-02-13T19:22:31.592000Z,0,True,1676315968,13,True,True,26,0005,26
3,14,2,66f873d641d448bd1572ab086665a458,49.260599,-123.113504,12th & Yukon (City Hall),2023-02-13T19:22:31.593000Z,0,True,1676316133,2,True,True,16,0007,16
4,7,9,485d4d24c803cfde829ab89699fed833,49.264215,-123.117772,8th & Ash,2023-02-13T19:22:31.604000Z,2,True,1676315653,7,True,True,16,0008,16
5,3,11,b07d513f87897cff7319a0e59d7e567c,49.270877,-123.115103,Spyglass & Seawall,2023-02-13T19:22:31.604000Z,1,True,1676316111,10,True,True,14,0009,14
6,12,2,d1c9556d92f329703229fb3e33899a3b,49.26893,-123.11813,Stamps Landing,2023-02-13T19:22:31.624000Z,0,True,1676315587,2,True,True,14,0010,14
7,13,7,95e624191c655f50e401d280cd39a9ad,49.271721,-123.104207,Ontario & Seawall,2023-02-13T19:22:31.624000Z,1,True,1676315924,6,True,True,20,0011,20
8,6,20,3e112f9fe877e0003780386359060ae6,49.287214,-123.11287,Canada Place,2023-02-13T19:22:31.622000Z,1,True,1676315914,19,True,True,26,0014,26
9,9,11,6993b3dbb0758927967592ea612a2b1e,49.282409,-123.118541,Granville & Georgia,2023-02-13T19:22:31.621000Z,0,True,1676316058,11,True,True,20,0015,20
10,13,13,bf8408067b0e0c963f3ff526977bcef3,49.287097,-123.118551,Pender & Burrard,2023-02-13T19:22:31.620000Z,1,True,1676316036,12,True,True,26,0016,26
11,2,20,d2244f1a81d317c76cabd65e81250835,49.273471,-123.118016,Marinaside & Davie,2023-02-13T19:22:31.619000Z,1,True,1676316100,19,True,True,22,0017,22
12,22,7,0b543fc4e694fe07a54dac48bb1b3390,49.282758,-123.122092,Robson & Hornby,2023-02-13T19:22:31.653000Z,2,True,1676316118,5,True,True,30,0019,29
13,1,21,1b4c6f63f4bfbbd983992dbdca776865,49.286042,-123.113176,Cordova & Granville,2023-02-13T19:22:31.678000Z,0,True,1676316141,21,True,True,22,0021,22
14,3,19,fbb1d30d7f30b049873f5be5688563d4,49.28602,-123.116624,Hornby & Pender,2023-02-13T19:22:31.691000Z,5,True,1676316036,14,True,True,22,0024,22
15,13,7,7181df50ee1d1a05559399211382b7c8,49.279739,-123.116251,Homer & Robson (Vancouver Public Library),2023-02-13T19:22:31.692000Z,0,True,1676316134,7,True,True,20,0025,20
16,15,3,2ef000bc9d4650d8cc6198c4d570b19f,49.277483,-123.114279,Beatty & Robson,2023-02-13T19:22:31.689000Z,1,True,1676316110,2,True,True,20,0026,18
17,8,6,b7683a86874e6300fd89f4cc0b075f57,49.275679,-123.116963,Beatty & Nelson,2023-02-13T19:22:31.690000Z,1,True,1676316098,5,True,True,14,0027,14
18,13,9,3367c1e1dbf73caf7c10e4c96a92f58d,49.282759,-123.106955,Abbott & Cordova,2023-02-13T19:22:31.388000Z,0,True,1676316033,9,True,True,22,0030,22
19,3,15,1d7e73b3321ebb6713774d376247d9f9,49.288444,-123.139203,Comox & Denman,2023-02-13T19:22:31.397000Z,0,True,1676315642,15,True,True,18,0032,18
20,5,12,664502c28e8147615f17b8ea355f40d0,49.289124,-123.12196,Cordova & Bute,2023-02-13T19:22:31.383000Z,2,True,1676316013,10,True,True,14,0034,17
21,15,3,6c24a62b5ee0a2a8014eb0dfb6d40025,49.28062,-123.12482,Hornby & Nelson,2023-02-13T19:22:31.384000Z,2,True,1676316043,1,True,True,18,0037,18
22,3,12,fad9ebcf614dd1a72593a34072ff76f8,49.279938,-123.127478,Helmcken & Burrard,2023-02-13T19:22:31.379000Z,2,True,1676315712,10,True,True,15,0039,15
23,13,1,3a4131fa94946d93d3529136efd62413,49.273663,-123.127075,Pacific & Richards,2023-02-13T19:22:31.429000Z,0,True,1676316013,1,True,True,14,0044,14
24,12,2,25318ec3e06fae1397a3a2f645104149,49.28972,-123.144028,Chilco & Beach,2023-02-13T19:22:31.431000Z,0,True,1676315670,2,True,True,14,0047,14
25,8,4,444991edc9550be0908f032da5e3c95f,49.285253,-123.134356,Comox & Broughton,2023-02-13T19:22:31.413000Z,0,True,1676315950,4,True,True,12,0048,12
26,15,7,434b6f4e7fc30198f901b60fc905f609,49.283343,-123.131099,Bute & Comox,2023-02-13T19:22:31.452000Z,0,True,1676315833,7,True,True,22,0050,22
27,8,24,f97d5bf41f35aa181288429fb52e3488,49.284605,-123.108662,Cambie & Water,2023-02-13T19:22:31.451000Z,3,True,1676315973,21,True,True,32,0052,32
28,2,26,fef69fb400210d861107a61db954d037,49.279821,-123.10802,Keefer & Abbott,2023-02-13T19:22:31.450000Z,4,True,1676316131,22,True,True,28,0053,28
29,9,7,9d3123425823420514b8ad410074f02d,49.278004,-123.105664,Expo & Carrall,2023-02-13T19:22:31.457000Z,1,True,1676316049,6,True,True,16,0054,16
30,3,11,f1ca711137cde59e824167a4274df888,49.279342,-123.101822,Keefer & Columbia,2023-02-13T19:22:31.456000Z,2,True,1676316133,9,True,True,14,0055,14
31,4,22,4f6ebf2026d540ffe40e29a80138ad5e,49.273833,-123.114373,Marinaside & Cooperage,2023-02-13T19:22:31.453000Z,0,True,1676315857,22,True,True,26,0057,26
32,7,19,be14efdc86dedd6a8cd338e78ab4e7c7,49.28526,-123.141809,Bidwell & Burnaby,2023-02-13T19:22:31.587000Z,0,True,1676316065,19,True,True,26,0060,26
33,17,13,6ddeafa873279951630a00191333c45d,49.281506,-123.120101,Robson & Granville,2023-02-13T19:22:31.585000Z,3,True,1676315880,10,True,True,30,0063,30
34,8,6,c7b5bec0b2f4ab9a2d3f9d837725620c,49.276115,-123.114496,Expo & Smithe,2023-02-13T19:22:31.574000Z,1,True,1676315880,5,True,True,14,0064,14
35,12,10,b9fd847d53fe45658fee4c46e7f562b8,49.272827,-123.147744,Cypress & Cornwall,2023-02-13T19:22:31.575000Z,0,True,1676315931,10,True,True,22,0065,22
36,13,15,c2be5403b1c101e8032cf6696457200e,49.269361,-123.13782,Anderson & 2nd,2023-02-13T19:22:31.574000Z,0,True,1676316108,15,True,True,28,0066,28
37,3,12,71c064fa93cab5f0b7306e6c923b77c4,49.2653,-123.13811,7th & Granville,2023-02-13T19:22:31.591000Z,0,True,1676316090,12,True,True,14,0069,15
38,11,3,96bf713e60bc35cc2feb5fd53a4f3471,49.262598,-123.138921,10th & Granville,2023-02-13T19:22:31.611000Z,2,True,1676315565,1,True,True,14,0070,14
39,5,9,8dc684732a2a25bdf63ec0ecccee4e6e,49.25894,-123.139272,14th & Granville,2023-02-13T19:22:31.610000Z,4,True,1676315727,5,True,True,14,0071,14
40,9,5,686c0fdb962e26e274d81fc286c010dd,49.258763,-123.115392,14th & Cambie,2023-02-13T19:22:31.613000Z,2,True,1676316029,3,True,True,14,0072,14
41,7,14,0cf6cd1809fa7f510812f5b052f578c4,49.266724,-123.104824,Ontario & 5th,2023-02-13T19:22:31.612000Z,2,True,1676315973,12,True,True,20,0073,21
42,15,3,93c88a18c673e2c72a6afa93d6b89f18,49.262141,-123.101961,10th & Main,2023-02-13T19:22:31.614000Z,2,True,1676315656,1,True,True,18,0074,18
43,8,10,8fb5ce1e34ad31de940481953aea452c,49.268269,-123.147885,Cypress & 4th,2023-02-13T19:22:31.616000Z,0,True,1676316094,10,True,True,18,0076,18
44,3,25,aa704bfba40286bd0661b64d1f75e778,49.275717,-123.142564,Vanier Park,2023-02-13T19:22:31.615000Z,0,True,1676316145,25,True,True,28,0077,28
45,9,11,8c9ea7f2132376859ef34fab981d6932,49.276436,-123.11877,Nelson & Mainland,2023-02-13T19:22:31.618000Z,1,True,1676315968,10,True,True,20,0078,20
46,9,9,1d4153659a0a0a2089078c739df6737d,49.277844,-123.120942,Nelson & Richards,2023-02-13T19:22:31.617000Z,6,True,1676316096,3,True,True,18,0079,18
47,4,14,fbb4c06b719596c21f91fd51ef6d4710,49.265089,-123.119425,7th & Heather,2023-02-13T19:22:31.674000Z,2,True,1676316104,12,True,True,18,0081,18
48,20,0,72c1049dfbbde7c24ec45c14f1a5ee85,49.28026,-123.135244,Harwood & Bute,2023-02-13T19:22:31.671000Z,0,True,1676315727,0,True,True,20,0088,20
49,18,0,00fa94ad698dc4a9e4d708d6fd32f294,49.291909,-123.140713,Chilco & Barclay,2023-02-13T19:22:31.719000Z,0,True,0,0,False,False,18,0092,18
50,9,7,efa947b901a2cf85b58320b3ad26a2fe,49.293257,-123.138563,Chilco & Robson,2023-02-13T19:22:31.718000Z,0,True,1676316029,7,True,True,16,0093,16
51,11,7,66a53e9c32e4f5c724f9478240020142,49.288011,-123.132006,Nicola & Robson,2023-02-13T19:22:31.716000Z,0,True,1676316083,7,True,True,18,0096,18
52,0,18,97b25faf822b93fdbf72da1d594c0288,49.28117,-123.104419,Carrall & Hastings,2023-02-13T19:22:31.715000Z,3,True,1676316081,15,True,True,18,0098,18
53,21,6,6c7fb9043e6df5a4cc50404581a947b9,49.283227,-123.120523,šxʷƛ̓ənəq Xwtl'e7énḵ Square - Vancouver Art Gallery,2023-02-13T19:22:31.714000Z,2,True,1676315804,4,True,True,28,0099,27
54,6,10,30bf49544b1c864688b78172d42cca5e,49.299292,-123.130281,Stanley Park - Vancouver Aquarium,2023-02-13T19:22:31.502000Z,0,True,1676315862,10,True,True,16,0101,16
55,4,12,9f63cebac9073eac3e90be2b9a91b02b,49.29534,-123.150433,Stanley Park - Second Beach North,2023-02-13T19:22:31.507000Z,2,True,1676316006,10,True,True,16,0102,16
56,10,8,9aa325529164ec68b4d96c4f1c4fc7c1,49.294318,-123.148808,Stanley Park - Second Beach South,2023-02-13T19:22:31.498000Z,1,True,1676316058,7,True,True,18,0104,18
57,10,10,e3d32ad772a5898c3b96c4d23d2cd542,49.298657,-123.121176,Stanley Park - Totem Poles,2023-02-13T19:22:31.496000Z,0,True,1676315847,10,True,True,20,0105,20
58,10,8,625a2ad202275c8e2be3ce868e85b105,49.259183,-123.120126,Heather & 14th,2023-02-13T19:22:31.501000Z,0,True,1676315978,8,True,True,18,0106,18
59,13,3,6c0de983fb47a3439a9e3c36a3d15804,49.263837,-123.105173,8th & Ontario,2023-02-13T19:22:31.499000Z,0,True,1676316093,3,True,True,16,0107,16
60,17,9,92c9e62c0b42adf4759c430009d3987a,49.270721,-123.146175,1st & Chestnut,2023-02-13T19:22:31.493000Z,1,True,1676315723,8,True,True,26,0108,26
61,7,9,51e4d3731aebbf9c3186f310a08de6c8,49.265605,-123.152566,7th & Arbutus,2023-02-13T19:22:31.492000Z,0,True,1676315559,9,True,True,16,0109,16
62,11,5,826af7eee4ce28b6fa4b4f0211305792,49.267222,-123.153157,5th & Arbutus,2023-02-13T19:22:31.447000Z,0,True,1676315995,5,True,True,16,0110,16
63,13,13,4cb84c9a3743287019ae00ceef9a1cd3,49.262255,-123.126217,10th & Oak,2023-02-13T19:22:31.446000Z,10,True,1676316079,3,True,True,30,0112,26
64,25,15,56fef9ba0af67a4ff3e661a8e02c0b08,49.257654,-123.153212,Arbutus & 16th,2023-02-13T19:22:31.447000Z,10,True,1676315957,5,True,True,40,0113,40
65,9,3,c81f75a80312c51ceaef1304beac1990,49.25919,-123.148268,Cypress & 14th,2023-02-13T19:22:31.449000Z,0,True,1676316119,3,True,True,12,0114,12
66,5,7,afacb2133f2462aba7748cc21b71c788,49.25741,-123.148531,Cypress & 16th,2023-02-13T19:22:31.450000Z,2,True,1676315667,5,True,True,12,0115,12
67,4,8,a9f0b06d07f89b75e92c0cf686223aea,49.285953,-123.124066,Georgia & Thurlow,2023-02-13T19:22:31.419000Z,0,True,1676315636,8,True,True,12,0123,12
68,14,1,686b314a6c3348efd2297d6b3dfed1a7,49.280881,-123.130672,Thurlow & Pendrell,2023-02-13T19:22:31.416000Z,0,True,1676316142,1,True,True,16,0126,15
69,6,5,0d1b5c62f8d22e3650811df55596e25b,49.256845,-123.120071,Heather & 16th,2023-02-13T19:22:31.398000Z,0,True,1676315604,5,True,True,12,0130,11
70,9,7,521c2122c791ed038168c3b8ff24061b,49.25849,-123.104799,14th & Ontario,2023-02-13T19:22:31.381000Z,2,True,1676315941,5,True,True,16,0132,16
71,9,5,838d5bb59963474ad08a6d5b156943ed,49.258425,-123.100792,14th & Main,2023-02-13T19:22:31.369000Z,0,True,1676315610,5,True,True,14,0134,14
72,5,13,b9ab6ce009eda6006ade1d7568d9db9c,49.270905,-123.126006,David Lam Park - West,2023-02-13T19:22:31.378000Z,0,True,1676316147,13,True,True,18,0136,18
73,9,9,9ec4163496363b31ab475cb851b57b21,49.273568,-123.129935,Beach & Seymour,2023-02-13T19:22:31.379000Z,0,True,1676316080,9,True,True,18,0137,18
74,14,2,fedff7a263c182df94bda7307059cc52,49.277141,-123.122589,Richards & Helmcken,2023-02-13T19:22:31.701000Z,1,True,1676315949,1,True,True,18,0138,16
75,6,10,b9baf685b7053de899bf3467f61c2781,49.267859,-123.145782,Burrard & 4th,2023-02-13T19:22:31.709000Z,0,True,1676316026,10,True,True,16,0139,16
76,9,7,8d6f0cbf7d44d2908c8ce73ed00dbf66,49.265336,-123.145823,Burrard & 7th,2023-02-13T19:22:31.399000Z,0,True,1676316117,7,True,True,16,0140,16
77,4,10,988f8f74c4a12d1a30ddf2f7cd6318f8,49.267628,-123.127698,South False Creek Seawall,2023-02-13T19:22:31.400000Z,3,True,1676315996,7,True,True,14,0143,14
78,14,2,2f09a64507cf6257c67ca20af27339eb,49.275938,-123.145939,Chestnut & McNicoll,2023-02-13T19:22:31.402000Z,0,True,1676315902,2,True,True,16,0147,16
79,8,8,73f388336d879bedc962cd412eb0296e,49.2756,-123.102661,Creekside Park North,2023-02-13T19:22:31.404000Z,1,True,1676316071,7,True,True,18,0148,16
80,7,13,cb6fddfdac7d350d25be475c7ab9e05a,49.284157,-123.099917,Alexander & Main,2023-02-13T19:22:31.667000Z,7,True,1676316036,6,True,True,20,0150,20
81,13,7,cadc004f0903ef45e898032143c0832f,49.258924,-123.152591,Arbutus Greenway & 14th,2023-02-13T19:22:31.712000Z,1,True,1676315630,6,True,True,20,0152,20
82,4,12,57e928d8c30fab0ebffb3ede850f89d6,49.266774,-123.141135,Arbutus Greenway & Fir,2023-02-13T19:22:31.713000Z,4,True,1676316057,8,True,True,16,0153,16
83,14,24,6526a2eb3832f9ba0224d237e901ea5b,49.273355,-123.154493,Kitsilano Beach Park,2023-02-13T19:22:31.711000Z,2,True,1676315771,22,True,True,39,0154,38
84,11,19,e44c2235dd603dbee54fe08f7543e85a,49.276144,-123.151272,Arbutus & McNicoll,2023-02-13T19:22:31.711000Z,5,True,1676316016,14,True,True,30,0155,30
85,11,7,3596b4831ee2ea7812de753b32306835,49.268339,-123.157443,Vine & 4th,2023-02-13T19:22:31.720000Z,0,True,1676315968,7,True,True,18,0159,18
86,10,4,c448b73d92f7f8e1daafb3b9c5fbe6a6,49.284062,-123.095097,Alexander & Dunlevy,2023-02-13T19:22:31.602000Z,1,True,1676316142,3,True,True,14,0161,14
87,7,7,5fc29e0ac42c11abb45bf12aaeb925bd,49.261742,-123.13148,Alder & 11th,2023-02-13T19:22:31.702000Z,4,True,1676316137,3,True,True,14,0166,14
88,9,5,61901a235d4cfceb7f8f2c3888b98617,49.262206,-123.109091,10th & Columbia,2023-02-13T19:22:31.565000Z,1,True,1676315870,4,True,True,14,0172,14
89,27,4,175a074bf65455d1633639511dc129c8,49.27023,-123.10651,1st & Manitoba,2023-02-13T19:22:31.566000Z,0,True,1676315955,4,True,True,32,0174,31
90,6,14,35eb539fb9298bb7e4f6759ca0256505,49.262062,-123.104656,10th & Ontario,2023-02-13T19:22:31.568000Z,7,True,1676315885,7,True,True,20,0176,20
91,6,14,7b8dfa12900bcb02b47a14e4e5010ba3,49.27033,-123.10275,Quebec & 1st,2023-02-13T19:22:31.569000Z,1,True,1676316082,13,True,True,20,0177,20
92,10,4,b30ed0719dd281867a4d39779c78b58a,49.258902,-123.109596,Columbia & 14th,2023-02-13T19:22:31.572000Z,0,True,1676316078,4,True,True,14,0180,14
93,16,2,e1a4d91fdae7e18483373f648141e53e,49.282224,-123.132778,Bute & Davie,2023-02-13T19:22:31.570000Z,0,True,1676316130,2,True,True,20,0187,18
94,4,10,ace20c241ee38643c9060f290b215b9d,49.265071,-123.123864,7th & Laurel,2023-02-13T19:22:31.538000Z,2,True,1676316107,8,True,True,14,0191,14
95,12,4,3aed670ccdcd94b966c0f505f8b028c7,49.265198,-123.131043,7th &  Alder,2023-02-13T19:22:31.535000Z,0,True,1676315613,4,True,True,16,0192,16
96,3,13,ae69aeab748d02e5a7d89da28a1a8511,49.273691,-123.102232,Science World,2023-02-13T19:22:31.536000Z,1,True,1676315870,12,True,True,16,0193,16
97,4,16,0c9ad3e3703e5869b82619ecdf54f43e,49.2685027,-123.0975014,1st & Scotia,2023-02-13T19:22:31.541000Z,3,True,1676316116,13,True,True,20,0197,20
98,8,12,852212d6d52b5f00544fad01d21c7db2,49.278529,-123.100017,Georgia & Main,2023-02-13T19:22:31.530000Z,0,True,1676315940,12,True,True,20,0199,20
99,6,9,f3708906ec71348f5a42579fede36a0d,49.288682,-123.11818,Shaw Tower,2023-02-13T19:22:31.478000Z,0,True,1676316008,9,True,True,18,0201,15
100,12,0,d145b7498709289702095a4a2fcb2e03,49.258864,-123.14353,Pine & 14th,2023-02-13T19:22:31.477000Z,0,True,0,0,False,False,12,0203,12
101,15,5,9449a6a83fbf88452e384350e5ac95b7,49.271741,-123.155421,York & Yew,2023-02-13T19:22:31.472000Z,0,True,1676315882,5,True,True,20,0204,20
102,16,4,365da33e9ce06ea53db1173a0f8eae71,49.262822,-123.14338,Pine & 10th,2023-02-13T19:22:31.474000Z,0,True,1676315933,4,True,True,20,0205,20
103,5,6,707c1c54e0278fbae5d0ae3c42a25b71,49.263635,-123.099236,8th & Scotia,2023-02-13T19:22:31.470000Z,0,True,1676315741,6,True,True,12,0206,11
104,13,7,5105df3dd0daf4c26980f4134f61e5cc,49.28763,-123.127245,Alberni & Jervis,2023-02-13T19:22:31.471000Z,1,True,1676316107,6,True,True,20,0207,20
105,9,11,82c794442f54fabf9db6e392ca1fac0f,49.297933,-123.130758,Stanley Park - Information Booth,2023-02-13T19:22:31.485000Z,0,True,1676315947,11,True,True,20,0209,20
106,6,8,2ca388bba54706770900ca2a9d7aa5be,49.258819,-123.131317,14th & Alder,2023-02-13T19:22:31.525000Z,0,True,1676315736,8,True,True,14,0211,14
107,5,9,e7bf01431a6982f032996ad50a9e5bd7,49.280284,-123.097052,Pender & Gore,2023-02-13T19:22:31.668000Z,0,True,1676315881,9,True,True,14,0213,14
108,4,14,1648ead5ea617d2cea115869d9516f5e,49.276294,-123.106534,Carrall & Seawall,2023-02-13T19:22:31.704000Z,1,True,1676315885,13,True,True,18,0218,18
109,5,8,91035fe1d70b65c9cb8ec4a007af7c7f,49.277469,-123.081315,Glen & Union,2023-02-13T19:22:31.692000Z,1,True,1676315714,7,True,True,14,0221,13
110,1,21,d3aaff4414a8c3fd5480c470f77ff68a,49.277665,-123.073653,Adanac & McLean,2023-02-13T19:22:31.484000Z,2,True,1676315873,19,True,True,22,0222,22
111,13,3,b307709b305dd04328fbbf2c6db86419,49.277436,-123.070427,Commercial & Adanac,2023-02-13T19:22:31.694000Z,1,True,1676315828,2,True,True,16,0223,16
112,8,8,e9c4bd1fffbb1e5b058b8ea15f7307f6,49.280332,-123.070068,Pender & Commercial,2023-02-13T19:22:31.699000Z,1,True,1676315861,7,True,True,16,0224,16
113,8,6,bb0847559ce71c93d8215c0997ea2811,49.279369,-123.091241,Keefer & Princess,2023-02-13T19:22:31.677000Z,1,True,1676316123,5,True,True,14,0229,14
114,11,9,1ef5c4ff3f0b09422bb1597fd9d7568b,49.283992,-123.091206,Alexander & Railway,2023-02-13T19:22:31.487000Z,1,True,1676315987,8,True,True,20,0230,20
115,7,7,ac3b8198f03754a0afb8b6ed6d220cdd,49.274881,-123.069323,Napier & Commercial,2023-02-13T19:22:31.407000Z,5,True,1676316120,2,True,True,14,0231,14
116,3,11,029a505bd4422a1afd127987757f71a6,49.275882,-123.071865,Britannia Parking Lot,2023-02-13T19:22:31.403000Z,0,True,1676315865,11,True,True,14,0232,14
117,8,6,0459b7e93703980b853cd65a9dc60596,49.273777,-123.092723,Thornton & National,2023-02-13T19:22:31.435000Z,1,True,1676315587,5,True,True,14,0233,14
118,18,10,a21f40838346e300063bdda3c5c04105,49.265005,-123.079481,Keith & 6th,2023-02-13T19:22:31.608000Z,3,True,1676316003,7,True,True,28,0236,28
119,12,8,209fb233aff275020a640c8c40a18d90,49.265024,-123.08127,Glen & 6th,2023-02-13T19:22:31.513000Z,0,True,1676315654,8,True,True,20,0237,20
120,11,3,6b1622540fe5c85d365754dd8c20bf0c,49.271377,-123.069416,Grant & Commercial,2023-02-13T19:22:31.669000Z,2,True,1676315689,1,True,True,14,0239,14
121,16,6,ebc551adb0fc1a684f4080e4954a9ba4,49.268616,-123.069908,2nd & Commercial,2023-02-13T19:22:31.643000Z,1,True,1676316055,5,True,True,22,0240,22
122,7,7,6eaa02e5bcf78db5386683d38fa2dabd,49.266969,-123.069936,4th & Commercial,2023-02-13T19:22:31.657000Z,2,True,1676315628,5,True,True,14,0241,14
123,21,17,983e58671adcc67af94457d7887dbb15,49.263242,-123.070521,8th & Commercial,2023-02-13T19:22:31.481000Z,3,True,1676315800,14,True,True,38,0242,38
124,22,4,797ff1725f8d2b18337de51e240ff60d,49.261403,-123.070102,10th & Commercial,2023-02-13T19:22:31.666000Z,1,True,1676315630,3,True,True,26,0244,26
125,10,4,277b4b4881bdb7dac73012672179def8,49.261263,-123.073707,Woodland & 10th,2023-02-13T19:22:31.599000Z,0,True,1676316146,4,True,True,14,0245,14
126,12,6,e1ff428dadc7c32141b9d89a7b56728a,49.262242,-123.081459,Glen & Broadway,2023-02-13T19:22:31.594000Z,1,True,1676316120,5,True,True,18,0246,18
127,8,6,012d3e06901cc222b1c2cf0a2ace3a29,49.262321,-123.09306,St George & Broadway,2023-02-13T19:22:31.458000Z,1,True,1676315845,5,True,True,14,0248,14
128,10,2,a6455af6b689bcbad07ae2c8a3419b50,49.264251,-123.073853,7th & Woodland,2023-02-13T19:22:31.603000Z,0,True,1676315604,2,True,True,12,0249,12
129,11,4,475627e149c1a6ba73caac8d8d2fa617,49.266751,-123.073501,Woodland & 4th,2023-02-13T19:22:31.606000Z,1,True,1676316147,3,True,True,14,0250,15
130,7,5,f387ec226c432c5c054e3d3616d90501,49.270684,-123.073562,Woodland & Graveley,2023-02-13T19:22:31.655000Z,5,True,1676316036,0,True,True,12,0252,12
131,5,9,1675a77b9af656faf527b4e6de53e63b,49.2731,-123.0732,Charles & Woodland,2023-02-13T19:22:31.607000Z,3,True,1676316021,6,True,True,14,0253,14
132,10,6,1bca0e944a4faf170db82793414b03ab,49.254667,-123.101389,18th & Main,2023-02-13T19:22:31.625000Z,1,True,1676315767,5,True,True,16,0255,16
133,9,5,d0782213f003ce9eb276fbceff44f1f4,49.256694,-123.096579,Prince Edward & 16th,2023-02-13T19:22:31.642000Z,4,True,1676316074,1,True,True,14,0256,14
134,9,5,1ef01f2f89621d51afbabaa6296e55be,49.258352,-123.096337,Prince Edward & 14th,2023-02-13T19:22:31.640000Z,0,True,1676315727,5,True,True,14,0257,14
135,5,11,c47a1f62ea461ce1c9f3e2478c657df6,49.258817,-123.092797,13th & St George,2023-02-13T19:22:31.570000Z,3,True,1676315683,8,True,True,16,0258,16
136,10,4,0cee06d7d10f7d3162cea03d22b7beed,49.26151,-123.089413,10th & Fraser,2023-02-13T19:22:31.459000Z,4,True,1676315903,0,True,True,14,0260,14
137,10,6,f62bc2bfe9a0a563d5b6745ce6d962ba,49.263382,-123.088837,8th & Fraser,2023-02-13T19:22:31.460000Z,0,True,1676316015,6,True,True,16,0261,16
138,9,3,1c8f7fd6535db12cc45cfc59aa9da058,49.261353,-123.085333,St Catherines & 10th,2023-02-13T19:22:31.489000Z,0,True,1676316069,3,True,True,12,0265,12
139,15,5,17a3320a52bcc62161908967f8a06613,49.264466,-123.085183,St Catherines & 7th,2023-02-13T19:22:31.490000Z,1,True,1676315690,4,True,True,20,0266,20
140,12,4,aed214941445e0345aa3254805a9e8b8,49.280197,-123.065859,Pender & Victoria,2023-02-13T19:22:31.561000Z,2,True,1676315640,2,True,True,16,0272,16
141,11,5,d67640af1b3b3b3ce47169dbc9182470,49.266725,-123.065925,Victoria & 4th,2023-02-13T19:22:31.560000Z,5,True,1676315955,0,True,True,16,0273,16
142,8,4,b2c6aaf2b4fa8937bfe3941c038683aa,49.261188,-123.066009,Victoria & 10th,2023-02-13T19:22:31.559000Z,3,True,1676316065,1,True,True,12,0274,12
143,12,5,0a43242bee10cd33f539af2c1bf5ecbf,49.256857,-123.065646,15th & Victoria (Trout Lake),2023-02-13T19:22:31.432000Z,1,True,1676315730,4,True,True,18,0278,17
144,10,6,198810b9b0af5d229d1b6fa12c620e06,49.283986,-123.065264,Triumph & Victoria,2023-02-13T19:22:31.467000Z,0,True,1676316112,6,True,True,16,0280,16
145,8,6,d02e2eaafda91425eddd24d8acd328ab,49.257985,-123.083366,Windsor & 14th,2023-02-13T19:22:31.468000Z,2,True,1676315989,4,True,True,14,0281,14
146,14,2,08c7a90bf297fde8c1f1156db13987d4,49.257939,-123.089531,14th & Fraser,2023-02-13T19:22:31.464000Z,2,True,1676315570,0,True,True,16,0282,16
147,7,7,97005696a3dff3366a8410b817388990,49.256496,-123.075426,15th & Knight,2023-02-13T19:22:31.465000Z,1,True,1676315930,6,True,True,14,0283,14
148,4,12,c52e51e3288a00993bdf892fdc2c2c2c,49.283236,-123.070443,Commercial & Pandora,2023-02-13T19:22:31.462000Z,1,True,1676315995,11,True,True,16,0285,16
149,6,10,7d231a181d21056e4ba80c4d9939fe92,49.267266,-123.090786,Carolina & Great Northern Way,2023-02-13T19:22:31.462000Z,0,True,1676316107,10,True,True,16,0287,16
150,11,5,dcf3d5c9f1b3a46f0ef2eb2247931f89,49.265242,-123.095577,6th & Prince Edward,2023-02-13T19:22:31.522000Z,0,True,1676315986,5,True,True,16,0297,16
151,10,6,9bee3167f10c884044cea0d36afcd1ef,49.265213,-123.090785,6th & Carolina,2023-02-13T19:22:31.514000Z,1,True,1676316058,5,True,True,16,0298,16
152,23,15,45a4c865db23e1cad0209afa5a799de0,49.302577,-123.155616,Stanley Park - Third Beach Parking Lot,2023-02-13T19:22:31.505000Z,1,True,1676315944,14,True,True,38,0103,38
153,10,6,fe0c57d04d6e682d284d501446095fc9,49.277595,-123.09583,Union & Dunlevy,2023-02-13T19:22:31.670000Z,0,True,1676316145,6,True,True,16,0212,16
154,3,13,b10d422b045805f1c350c47c983381e8,49.279235,-123.087528,Keefer & Hawks,2023-02-13T19:22:31.676000Z,0,True,1676315567,13,True,True,16,0228,16
155,9,7,4e8fdc99e77ba1b70d90e124a704d0c1,49.277333,-123.087359,Hawks & Union,2023-02-13T19:22:31.703000Z,0,True,1676315740,7,True,True,16,0219,16
156,17,5,b562f08327af465e4531e20226789489,49.273103,-123.069892,Charles & Commercial,2023-02-13T19:22:31.389000Z,4,True,1676315798,1,True,True,22,0235,22
157,13,6,4ac99b928a91d8ccb785c9d0b805adb6,49.261973,-123.09725,10th & Kingsway,2023-02-13T19:22:31.571000Z,3,True,1676316113,3,True,True,20,0186,19
158,12,6,99c81f71db35911c79a86a1c5edc5604,49.275295,-123.132585,Beach & Hornby,2023-02-13T19:22:31.430000Z,1,True,1676315879,5,True,True,18,0045,18
159,13,15,e12234b6f1299d178f34bffaca92f043,49.285871,-123.12105,Burrard Station (Melville & Dunsmuir),2023-02-13T19:22:31.598000Z,0,True,1676315965,15,True,True,28,0002,28
160,10,4,5a34495280727a5b50b9aa41e14e9a16,49.284893,-123.128685,Bute & Barclay,2023-02-13T19:22:31.408000Z,0,True,1676315629,4,True,True,14,0300,14
161,9,13,9130f9aa3bb037a04c17e6f2630327e5,49.263962,-123.112621,8th & Yukon,2023-02-13T19:22:31.562000Z,0,True,1676316011,13,True,True,22,0170,22
162,6,6,9a48ca226f82f52d02707b054ebc7e9e,49.277615,-123.091654,Princess & Union,2023-02-13T19:22:31.532000Z,0,True,1676315887,6,True,True,12,0215,12
163,9,13,b3bb9f58d3530d33a1a09b6be9e973e0,49.282214,-123.114101,Dunsmuir & Richards,2023-02-13T19:22:31.623000Z,2,True,1676315570,11,True,True,22,0012,22
164,7,13,c2f4e05c01ea0d27934ac7dbc50cbd0c,49.266456,-123.100324,5th & Main,2023-02-13T19:22:31.528000Z,1,True,1676315991,12,True,True,20,0198,20
165,2,17,9a5478470b56379c31cf4e671584d5cc,49.268216,-123.103168,3rd & Quebec,2023-02-13T19:22:31.510000Z,0,True,1676315987,17,True,True,20,0119,19
166,8,16,257715b845828e027ff35dd0f11c971e,49.284554,-123.111031,Richards & Cordova,2023-02-13T19:22:31.418000Z,2,True,1676315836,14,True,True,24,0124,24
167,11,11,910027847876403b57f1013c16504688,49.280216,-123.117639,Richards & Robson,2023-02-13T19:22:31.430000Z,2,True,1676315822,9,True,True,22,0129,22
168,10,16,06487275cd19694152824c7c3088e8ff,49.266314,-123.116011,Olympic Village Station,2023-02-13T19:22:31.593000Z,1,True,1676316119,15,True,True,26,0006,26
169,6,8,b428c0e64d9b9fdb3bf8e85c95ffdf6b,49.280852,-123.084746,Campbell & Hastings,2023-02-13T19:22:31.511000Z,1,True,1676315658,7,True,True,14,0227,14
170,15,3,d085c6749a32517e1fb0d070e4128402,49.285512,-123.1384,Cardero & Davie,2023-02-13T19:22:31.427000Z,0,True,1676316075,3,True,True,18,0040,18
171,12,22,a6aec7b8c25da4c02829cd7839b8933d,49.27821,-123.136972,Aquatic Centre,2023-02-13T19:22:31.676000Z,0,True,1676315759,22,True,True,35,0083,34
172,6,16,c924f6a41b130fad49cfae47271314bc,49.281301,-123.139108,Beach & Broughton,2023-02-13T19:22:31.672000Z,1,True,1676316018,15,True,True,22,0084,22
173,1,20,8e93d0da1ee6caadf21ed9575b5fa9da,49.283298,-123.142288,Beach & Cardero,2023-02-13T19:22:31.401000Z,2,True,1676316145,18,True,True,22,0142,21
174,16,2,9413725a5d3bb5ce2ad0682b07a3ffab,49.280787,-123.115271,Georgia & Homer,2023-02-13T19:22:31.405000Z,1,True,1676315871,1,True,True,18,0305,18
175,4,14,7ed043a19e6a4ece742fe747b663bdbf,49.266476,-123.109389,Columbia & 5th,2023-02-13T19:22:31.605000Z,0,True,1676315994,14,True,True,18,0165,18
176,4,14,ce5dccf5a0f190bb4567a2fd93e7971e,49.290587,-123.13625,Haro & Denman,2023-02-13T19:22:31.421000Z,0,True,1676316139,14,True,True,20,0122,18
177,16,6,844aa75af0d3235a86ff827c81395afd,49.312568,-123.144177,Stanley Park - Prospect Point,2023-02-13T19:22:31.504000Z,1,True,1676316026,5,True,True,22,0100,22
178,13,5,1d442ad1a71774c82688a45954e47bfd,49.262835,-123.152626,Arbutus & 10th,2023-02-13T19:22:31.613000Z,0,True,1676315824,5,True,True,18,0075,18
179,10,4,2781435bde344e1b64f1bebac6bc9008,49.256825,-123.105234,Ontario & 16th,2023-02-13T19:22:31.382000Z,4,True,1676315939,0,True,True,14,0133,14
180,8,6,e9b37f2d9b7b2e2e3ade73f13acb69b2,49.275683,-123.124388,Richards & Davie,2023-02-13T19:22:31.675000Z,2,True,1676316120,4,True,True,14,0082,14
181,11,6,fffd87607aaae16fbb1f71615cbe7d17,49.263518,-123.09568,8th & Prince Edward,2023-02-13T19:22:31.495000Z,1,True,1676316083,5,True,True,18,0262,17
182,18,1,da8b6e94f90ad41a3f8de10596992372,49.28691,-123.128818,Jervis & Robson,2023-02-13T19:22:31.708000Z,0,True,1676315729,1,True,True,20,0310,19
183,12,8,32f70f7ae14ba87523c6286a6c4d5c37,49.282503,-123.124697,Smithe & Burrard,2023-02-13T19:22:31.533000Z,1,True,1676315948,7,True,True,20,0217,20
184,18,1,df5ab349a7a85d4b10da4cc3ec65c607,49.283749,-123.136133,Broughton & Davie,2023-02-13T19:22:31.673000Z,1,True,1676315983,0,True,True,22,0087,19
185,9,5,e0318460138ffbf4692005d5b5a9f900,49.262944,-123.148109,Cypress & 10th,2023-02-13T19:22:31.590000Z,0,True,1676315948,5,True,True,14,0068,14
186,7,13,db51c556fe50ec1deefbc9697c70cb51,49.27029,-123.135025,Granville Island,2023-02-13T19:22:31.573000Z,4,True,1676315728,9,True,True,20,0189,20
187,7,9,58a026f0c506caec20697a4f90538450,49.280427,-123.074082,McLean & Pender,2023-02-13T19:22:31.700000Z,4,True,1676315997,5,True,True,16,0225,16
188,16,2,0e0aef6fabaa808b3a3cef24657257a4,49.279259,-123.119145,Richards & Smithe,2023-02-13T19:22:31.448000Z,2,True,1676315867,0,True,True,18,0058,18
189,11,15,90c746df94ce1a12f1f617acfe4a8ce3,49.285836,-123.127265,Bute & Robson,2023-02-13T19:22:31.387000Z,2,True,1676316128,13,True,True,26,0036,26
190,14,6,80b5c12ef21fd47275d37b2c9935249c,49.272969,-123.164325,Trafalgar & Cornwall,2023-02-13T19:22:31.588000Z,0,True,1676316065,6,True,True,20,0460,20
191,20,4,899f59a9994302e8e1e4be01117ef707,49.27247,-123.185643,Alma & Point Grey,2023-02-13T19:22:31.706000Z,2,True,1676315587,2,True,True,24,0410,24
192,8,6,8d2d5bb3b9142f781f2a7f441e6bad7a,49.271471,-123.17731,Point Grey & Blenheim,2023-02-13T19:22:31.482000Z,0,True,1676315989,6,True,True,14,0440,14
193,11,12,5de0fe55497681d4cc9dd25509cf51ab,49.290112,-123.127062,Hastings & Broughton,2023-02-13T19:22:31.383000Z,0,True,1676315966,12,True,True,24,0035,23
194,12,6,2681455ba2d97283998a806b14d3e95c,49.263523,-123.155267,Yew & Broadway,2023-02-13T19:22:31.705000Z,2,True,1676316138,4,True,True,18,0484,18
195,15,7,064a7b39b1dbc4bfc4cf8f454e360c57,49.264928,-123.168068,8th & Macdonald,2023-02-13T19:22:31.508000Z,0,True,1676316064,7,True,True,22,0452,22
196,2,16,9c1397c06e07bf74fc049f1a0872eea0,49.264483,-123.173926,Balaclava & Broadway,2023-02-13T19:22:31.479000Z,2,True,1676315887,14,True,True,18,0444,18
197,24,2,9763838317308a4766b83696986a157b,49.264579,-123.18373,Dunbar & Broadway,2023-02-13T19:22:31.707000Z,1,True,1676316128,1,True,True,26,0415,26
198,10,6,c64ee19c62a363019ddbaedf71df2882,49.263746,-123.069892,Grandview & Commercial,2023-02-13T19:22:31.626000Z,2,True,1676316146,4,True,True,16,0254,16
199,10,3,421516af381a11f54d07fc79be68d3d3,49.258761,-123.127071,14th & Oak,2023-02-13T19:22:31.475000Z,0,True,1676316050,3,True,True,14,0202,13
200,9,9,38f045e3f43f86eae42ca4c60257ade0,49.268974,-123.190701,Wallace & 4th,2023-02-13T19:22:31.662000Z,1,True,1676315953,8,True,True,18,0401,18
201,13,7,5ba6e9725b1b0ee8cd25df976e47726b,49.273011,-123.159663,Balsam & Cornwall,2023-02-13T19:22:31.610000Z,0,True,1676316145,7,True,True,20,0470,20
202,8,8,f90ed7ad754ec04b7852941a480a4c77,49.266924,-123.173849,Balaclava & 6th,2023-02-13T19:22:31.445000Z,1,True,1676315595,7,True,True,16,0443,16
203,8,8,abfaf72456a4828a22f5bf60d3a80777,49.264326,-123.164725,Trafalgar & Broadway,2023-02-13T19:22:31.380000Z,0,True,1676316011,8,True,True,16,0464,16
204,10,6,2ff7eb4230654603592ab1b0780ec5e1,49.266636,-123.183661,Dunbar & 6th,2023-02-13T19:22:31.707000Z,2,True,1676315901,4,True,True,16,0414,16
205,20,4,ea9485fcdce0611243474d000e4ad248,49.254818,-123.114785,18th & Cambie,2023-02-13T19:22:31.433000Z,4,True,1676315985,0,True,True,24,0531,24
206,18,6,671ce9e4a92063620f772d2c57f0f3ab,49.268837,-123.177633,Blenheim & 4th,2023-02-13T19:22:31.436000Z,0,True,1676315756,6,True,True,23,0431,24
207,9,7,41a55a7e2908fbbd65175b794d26bc8d,49.255034,-123.120226,18th & Heather,2023-02-13T19:22:31.524000Z,0,True,1676316146,7,True,True,16,0511,16
208,8,8,a59924f0ff3fb481a7bd8a5e9c36858f,49.271044,-123.170661,Point Grey & Bayswater,2023-02-13T19:22:31.557000Z,4,True,1676315958,4,True,True,16,0450,16
209,10,6,89a0b49a66e54a7639ad960962148a3e,49.252691,-123.101289,20th & Main,2023-02-13T19:22:31.438000Z,1,True,1676315689,5,True,True,16,0561,16
210,10,8,44fc3d58831a9f2b919c7a3a1838b74a,49.272172,-123.097978,Station & Terminal,2023-02-13T19:22:31.517000Z,0,True,1676315619,8,True,True,18,0354,18
211,14,20,d40db8c27c5bd409d57cfa846f73c378,49.271082,-123.191458,Jericho Beach,2023-02-13T19:22:31.659000Z,1,True,1676316134,19,True,True,34,0400,34
212,19,5,4990fe5772f3b73eebeec125b41e478e,49.27808,-123.130557,Burrard & Drake,2023-02-13T19:22:31.671000Z,0,True,1676315982,5,True,True,24,0089,24
213,9,13,bf96df77771ef0ed710d8e0e67917f45,49.269969,-123.109623,Columbia & 1st,2023-02-13T19:22:31.565000Z,0,True,1676315885,13,True,True,24,0173,22
214,3,27,e75e83499d3fa2e174dc2a8ffd238119,49.287528,-123.142139,Davie & Beach,2023-02-13T19:22:31.693000Z,3,True,1676316103,24,True,True,30,0028,30
215,20,6,0438114d2e6b96118de69bc9775bb21e,49.28803,-123.142135,Morton & Denman,2023-02-13T19:22:31.388000Z,0,True,1676315865,6,True,True,26,0031,26
216,11,3,07b13214cb69f2ec007d888450f3d6bc,49.259579,-123.114769,13th & Cambie,2023-02-13T19:22:31.710000Z,2,True,1676315711,1,True,True,14,0311,14
217,2,15,f5e8fa1fc4252bda2f93dd27ed2d603f,49.2890705989865,-123.138407369468,Nelson & Denman,2023-02-13T19:22:31.717000Z,0,True,1676315944,15,True,True,18,0313,17
218,5,9,c2a9c5d0e4578b928554c86f3d2c1162,49.287782,-123.12395,Melville & Bute,2023-02-13T19:22:31.537000Z,0,True,1676316045,9,True,True,14,0190,14
219,0,19,5f45325fdd6334a4c0d3b62853b19fa6,49.28512,-123.11242,Seymour & Cordova,2023-02-13T19:22:31.521000Z,3,True,1676315240,16,True,True,19,0308,19
220,13,5,085a0e120a08a80a58c0ae0ff9da565a,49.247854,-123.153422,Arbutus & Nanton,2023-02-13T19:22:31.601000Z,3,True,1676316136,2,True,True,18,0480,18
221,7,9,8d5f47f01d7ad668419dfe9b7fe69c9a,49.265939,-123.1129,Yukon & 6th,2023-02-13T19:22:31.563000Z,6,True,1676315759,3,True,True,18,0171,16
222,7,4,bede4b24dae115d4cd43d2e6cc9812cb,49.261122,-123.097571,11th & Kingsway,2023-02-13T19:22:31.557000Z,2,True,1676316109,2,True,True,16,0179,11
223,11,6,680b1ddfd50c4397b365c9c00f09b0d1,49.267725,-123.11311,Wylie & 2nd,2023-02-13T19:22:31.401000Z,0,True,1676315943,6,True,True,18,0144,17
224,11,9,b26f83e904f3a778466ebcd763b7316a,49.245135,-123.116098,29th & Cambie,2023-02-13T19:22:31.460000Z,0,True,1676316082,9,True,True,20,0526,20
225,9,7,6620c54bd6b3a79800b2b67e999b24d0,49.274232,-123.129998,Rolston & Granville,2023-02-13T19:22:31.715000Z,0,True,1676315752,7,True,True,16,0314,16
226,11,9,7f091b50fbbd892bf9fb869a64c47120,49.238105,-123.154966,East Blvd & 37th,2023-02-13T19:22:31.618000Z,2,True,1676315891,7,True,True,20,0482,20
227,10,10,57d39a680c9407cda0fb4de6d9c55138,49.246243,-123.124373,28th & Willow,2023-02-13T19:22:31.406000Z,6,True,1676315782,4,True,True,20,0505,20
228,5,7,97388f4e4ea102a30345524bda465f4e,49.249722,-123.104991,Ontario & 23rd,2023-02-13T19:22:31.719000Z,2,True,1676315764,5,True,True,12,0554,12
229,13,9,066ecc3584913fa035ec1417323beb80,49.243375,-123.104978,30th & Ontario,2023-02-13T19:22:31.658000Z,0,True,1676315864,9,True,True,22,0557,22
230,13,7,b530d04d393d71cffb8b8b07f4a82380,49.282087,-123.056909,Franklin & Nanaimo,2023-02-13T19:22:31.609000Z,5,True,1676316055,2,True,True,20,0642,20
231,8,9,06bdc4d55f34b2a491305534fd5defda,49.283968,-123.061615,Lakewood & Triumph,2023-02-13T19:22:31.589000Z,0,True,1676315909,9,True,True,16,0631,17
232,8,10,8e44a17d2fa446ca220b90c7063b42ca,49.287464,-123.060771,Wall & Eton,2023-02-13T19:22:31.437000Z,1,True,1676316068,9,True,True,18,0611,18
233,9,9,7c17f51469f1a7145455f65ef6afbd87,49.285575,-123.061575,Lakewood & Oxford,2023-02-13T19:22:31.562000Z,3,True,1676316108,6,True,True,18,0621,18
234,8,6,e1432b72df561a1df34290679ec9c773,49.251358,-123.115637,22nd & Cambie,2023-02-13T19:22:31.434000Z,3,True,1676316079,3,True,True,14,0532,14
235,9,8,549f00f6039e8bb702a00dcca08a8ed0,49.249184,-123.116141,King Edward & Cambie,2023-02-13T19:22:31.461000Z,5,True,1676315738,3,True,True,18,0524,17
236,11,11,d8c4fe5e09b6f010fbaa85cc7302d66b,49.245535,-123.120496,Heather & 29th,2023-02-13T19:22:31.519000Z,2,True,1676315757,9,True,True,22,0516,22
237,10,16,0c42f45e4a14957ad4a6d521d0ba8bc3,49.289255,-123.132677,Cardero & Robson,2023-02-13T19:22:31.428000Z,0,True,1676316054,16,True,True,26,0041,26
238,17,0,62a202eb98c0a4b09ba6746f5ee94ab3,49.252656,-123.067965,Commercial & 20th,2023-02-13T19:22:31.516000Z,0,True,1676315899,0,True,True,20,0352,17
239,21,2,a6c6df138cbc97b9f81e7ffbbebdde6f,49.277527,-123.129464,Hornby & Drake,2023-02-13T19:22:31.540000Z,0,True,1676316133,2,True,True,24,0196,23
240,11,7,04f64fde5ba1ebde8ad78c74914adb34,49.259469,-123.145718,Burrard & 14th,2023-02-13T19:22:31.527000Z,2,True,1676316035,5,True,True,18,0210,18
